labirintos para testes:

11m111111
100000001
101001001
101001001
100100001
1111111e1

11m111111
100000001
101001101
101001101
100100101
1111111e1