11m111111
100000001
101001001
101001001
100100001
1111111e1