11m111111
100000001
101111001
111001001
100100001
1111111e1