11m111111
100001001
10111111e
111001001
100100101
111111111