11m111111
10000000e
101001001
101001001
100100101
111111111